####################
#P ####   #   #O   #
#       # # X ###  #
########  #   ###  #
######OO       #   #
#    #  ### ####   #
# X                #
#    #  #####      #
####################
