    #########
    #       #
    #  ##X  #
#####  #    #
P           #
######   ###
     #  ###
     #    #
     #   ##
     #  ####
     #   O #
     #######